111111111111111111111-
444441444144441111111-
111141414141141111111-
111141414141141111111-
111141414141141111111-
111141414141141111111-
111141414141141111111-
111144414441144444444-
111111111111111111111-
111111111111111111111-
111111111111111111111